SO ./textures/bluestone.xpm
NO ./textures/redbrick.xpm
WE ./textures/barrel.xpm
EA ./textures/mossy.xpm

F 0,0,250
C 255,0,0


1111111111111111111111111111111111111111111111111111111                          11111111111111111111111111111111111111
1000000000000000000000000000000000000000000000000000001                          10000000000000000000000000000000000001
1000000000000000000000000000000000000000000000000000001                          10000000000000000000000000000000000001
1000000000000000000000000000000000000000000000000000001                          10000000000000000000000000000000000001
1000000000100000000000000000000000000000000000000000001                          10000000000000000000000000000000000001
1000010000000000000000010000000000000000000000000000001                          10000000000000000000000000000000000001
1000000000010000000000000000000000000000000000000000001                          10000000000000000000000000000000000001
1000000000000000000000000000000000000000S000000000000011111111111111111111111111110000000000000000000000000000000000001
11111111111110000000000000000000000000000000000000000000000000000000000000000000000000000000000000000000000000000000001
            11111111111111111111111111111111111111111111111111111111111111111111111111111111111111111111111111111111111
