1111111111111111111111
1000000000101000000011
1000000000000000000111
100P00000C000C00000001
100000000010C000000001
100000C0001000000000E1
1000000001100110000001
1111111111111111111111
